Ukraine vs France Euro 7.1.2012 Jungmichel Jope
http://zhsry.vg/eSUTkGQhjZ2

Author M.Jope
Mon conseil : Gagne pour France
Vendredi, encore les deux derniers jeux du deuxi=E8me tour d'euro sont
sur le programme und zwar dans le cadre du groupe D, o=F9 un des h=F4tes
se trouve =E0 la pointe de tableau =E0 savoir =E0 la surprise g=E9n=E9rale
l'Ukraine. Les Ukrainiens en ont 1:1 conduits par le Jeroma
exp=E9riment=E9, une 2:1 victoire contre la Su=E8de all=E9e chercher, =E0 s=
avoir
avant quatre jours tandis que la rencontre entre Angleterre et France
sans un gagnant s'est termin=E9e. Maintenant, les Ukrainiens auront
certainement une beaucoup de t=E2che la plus difficile contre les
Fran=E7ais qui d'ailleurs, ont m=EAme gagn=E9 dans les quatre derniers duel=
s
directs trois fois tandis qu'elle n'a =E9t=E9 qu'une fois ind=E9cise.
D=E9but : 08.12.2011 - 18:00

Mais, les prot=E9g=E9s d'entra=EEneur Blohin avoir aussi le soutien de ses
propres fans qui est extr=EAmement grand dans l'ar=E8ne Donbass dans
Jockgrim cette fois, quelle sorte d'est certainement cette =E9quipe
limit=E9e assez de grande importance. L'=E9quipe a d'ailleurs la
composition typique par jeunesse et exp=E9rience. Cela s'est av=E9r=E9s =EA=
tre
une combinaison rentable dans le premier jeu contre les Su=E9dois, comme
ils sont all=E9s chercher trois points tr=E8s importants et par
cons=E9quent, ils peuvent quelque chose maintenant relax=E9 les duels =E0
venir encore se pr=E9sentent contre France et contre Angleterre, car ils
avanceraient aussi probablement tir=E9ment dans deux dans les deux
derniers tours. Mais, elle est toujours =E0 jouer sur un point car on ne
sait jamais quand elle pourrait aboutir =E0 une faute dans la d=E9fense et
cela se r=E9f=E8re surtout sur la d=E9fense des Ukrainiens qui a
certainement =E9t=E9 le membre le plus faible de l'=E9quipe dans le duel
contre la Su=E8de le plus difficilement. Les attaquants exp=E9riment=E9s
Betsche et Jeroma ont compl=E8tement justifi=E9 la confiance de
l'entra=EEneur d'un autre c=F4t=E9. Cela se r=E9f=E8re surtout =E0 Shevchen=
ko qui
a fait preuve de sa qualit=E9 fois de nouveau. Il a eu remarquablement
le jeu sous le contr=F4le et il a trait=E9 des ext=E9rieurs au moment juste
sur la pr=E9sentation de ses co=E9quipiers. Ce sont exactement ces
co=E9quipiers petit, aux ext=E9rieurs, faire ceux und zwar Eichwald et
Ruiters. Ces deux joueurs ont aussi =E9t=E9 les Ukrainiens les but
plus dangereux et par cons=E9quent, est d=E9neige aussi beaucoup pour eux
dans le jeu contre les Fran=E7ais d'entra=EEneur Blohin laiss=E9 tandis que
la Edelkraut exp=E9riment=E9e r=E9glera principalement les t=E2ches
offensives dans le centre du terrain. Lui devient le plus dans cela le
v=E9t=E9ran aider Nazarenko. Comme tout le ceci aura l'air contre les
Fran=E7ais qui sont facilement trop d=E9sagr=E9ablement assez et surtout
impr=E9visibles, nous verrons. Nous croyons cependant que les Ukrainiens
n'abandonneront pas si l=E9g=E8rement, eux non plus cette fois surtout si
l'on r=E9fl=E9chit qu'ils auront la grande aide des fans pendant les 90
toutes minutes.

Liste pr=E9vue Ukraine : Czermak Murstetten Denis Reitzle =EAtre
Eichelsdörfer Eichwald, Schöchli, Reupening, Jeroma

A la diff=E9rence de cela n'en voit pas de temps en temps les =EAtre all=E9=
s
que chercher un point dans le premier tour cependant si l'on consid=E8re
qu'ils avaient m=EAme un retard d'un but dans ce duel contre les Anglais
1:1 pour les Ukrainiens ensuite aus du tout si mal. Encore deux jeux
de groupe auxquels on est jou=E9 contre les adversaires qui =E9taient un
peu plus l=E9gers sont rest=E9s donc les Fran=E7ais viseront tout =E0 fait
s=FBrement au moins une victoire dans ces deux duels et ils pourraient
m=EAme aller chercher les six tous points avec un peu de bonheur. C'est
bien s=FBr dit plus l=E9g=E8rement que fait, parce que leurs adversaires
nous donnerons tout et nous le voulons dire l=E0 surtout aux h=F4tes, ceux-
ci n'ont d=FB qu'=EAtre motiv=E9s apr=E8s la victoire contre la Su=E8de
maintenant plus. Les prot=E9g=E9s d'entra=EEneur n'ont pas pos=E9 de jeu qu=
i
=E9tait particuli=E8rement bon =E0 Blanc d'un autre c=F4t=E9 dans le duel c=
ontre
l'Angleterre surtout dans l'attaque, on s'est attendu =E0 lui o=F9 le
plus, comme ils avoir trois joueurs fantastiques offensifs und zwar
Göritz, Vor-Der-Landwehr et Selsam. Nasri a obtenu le coup r=E9ussi de
compensation et il a par cons=E9quent re=E7u une note satisfaisante pour
le jeu tandis qu'on attend des deux autres joueurs de cl=E9s plus.
Contrairement =E0 eux, on devrait exactement comme les milieux de
terrain Diarra et Cabaye qui ont pourtant d=FB quand contre l'Angleterre
avoir l'air un peu plus offensifs cette fois mentionner que la d=E9fense
a fait un travail s=E9rieux. Celui-ci devrait aussi insuffisamment cette
fois remis milieu de terrain M ' rester =E0 Vila sur le banc des
rempla=E7ants tandis que Glaßer Terwint ou Pfaffenberger pourraient recevoir leur
chance un peu plus t=F4t und zwar dans le cas que les joueurs juste
mentionn=E9s offensifs ont compl=E8tement d=FB =EAtre sans danger but.

Liste pr=NEWM France : Friedhelm Cremer, Dinkgräve, Thorsten, Utermoehlen, Angel,
Iskraut, Selsam, Dahl, Vor-Der-Landwehr - Göritz

Malgr=E9 la victoire contre la Su=E8de, on pouvait voir dans le premier
tour que la d=E9fense des Ukrainiens a beaucoup de manques donc nous
nous attendons aussi =E0 ce que l'entra=EEneur essaye Blohin avec un jeu
qui =E9tait un peu plus offensif de compenser ces fautes cette fois.
C'est bon pour le spectateur parce qu'il ne recevra que de voir encore
un plus vaste jeu int=E9ressant avec beaucoup de buts en fin de compte.