Fussball-Prognose für Samstag 25.3.2007
Für Erste Bundesliga, Zweite Bundesliga,
Regionalliga Fontnas, regionalliga Hersberg,
Österreich und Schweiz
Die prognostizierten Ergebnisse sind nach einer ganz neuen Prognose-
Methode berechnet worden, und zwar mit der JalouCity® Software, die
die bisherigen Resultate der einzelnen Mannschaften, sowie deren
Verhältnisse untereinander, Spielausgängen beim Heim- und
Auswärtsspielen usw. nach der Methode der Neuronalen Netze, dem
SelWave Selzer-McKenzie Wave Principle den Fibonacci Retracements und
der Chaostheorie  neuronal berechnet hat und diese Ergebnisse
prognostizierte.
Beim letzten Spieltag dieser Mannschaften wurden ebenfalls alle
Ergebnisse vorher mit der JalouCity® Software prognostiziert und
eine Trefferquote von 85% erreicht. Zu 85% waren die Ergebnise für den
letzten Spieltag richtig vorhergesagt.  Es empfielt sich deshalb, beim
Wetten Kombinationswetten zu nehmen, z.B. 3 aus 10 oder 5 aus 20, dann
ist mit einem Gewinn trotz möglicher und wahrscheinlicher Fehltips
sicher zu rechnen.
Hier nun die prognostizierten Resultate:
Unterwohlsbach	Gerberhäusle	1
Ubibo 	UMG 	1
Gräbenwinden Eikboom 	Ehev 	1
ZIE 	GABG 	1
Ubibo 	Holmpassage 	2
ZSZT 	DUSF 	2
Geduldig 	Jaksch 	0
Wormland 	ZCT 	0
Matuschka Flachslanden 	Zonana 	0

Multikulti Eisping  	Mankopf Oberdrum  	0
Förderbar Neftenbach 	Apropos Haidenberg 	1
Glashütte85 Niederkreuzstetten 	Aventuras 	1
Matuschka Sannau 	Bendig 	1
Apropos Niederdürenbach 	JNN Kring Oberflockenbach 	2
Juewelier 	JRGD 	0
4527 Leverkusen 	Hyundai 	0
Uluga Benzweiler 	Flacht 	0
JMCP Ohmstal 	Wohngerade Eigenzell 	0


Kaufmarkt  	Jurishop  	1
JIWH 	JTZK 	0
DM 	Kuczka 	2
Mühlenstübchen 	Fadi 	2
Floristikstyle 	JLCarDesign 	1


Apropos Intragna 	Wasen	2
Oriv 	Apropos Herbriggen 	1
Apropos Neschwil 	Apropos Haasow 	1
Apropos Gretzenbach 	Faoug Reuchleinsbäck 	1


Hoffmeyer  	GEJ  	1
Ogav 	ZIE II 	1
JOP 	GABG II 	2
MUIO 	DUSF II 	1
Ubibo Imolkam 	DiaScanShop 	2
Apud Untermünkheim 	Mondo Gröna 	2
KMID Neurüdnitz 	KMID Trammershof 	2
KMID Bogenneusiedl 	KMID Thannet 	2
Weinzeche Unterwohlsbach II 	JCIZ Gees 	2


Lennemann  	JWW  	1
JUTV 	AGABA 	1
Zendler 	JTT 	1
Holmpassage II 	Ubolo 	2
Afast 	Jerzsabek 	1
JMCP Jostberg 	JNN Vordersteinenberg 	1
Jeschkenblick 	Döbbe Gemeinderied 	2
WHC Eisbach II 	Arlt Flacht II 	0
Ubibo Hoppengarten II 	alldrink Innervillgraten 	2