für alle, dies interessiert:

NLS	NZR
AA	Alumin.Co.of Am.
N2000	NKVL
T	Nordoel
SCC	Strehmel
BA	Umesam
CAT	Amit Inc.
Aber	Agab.
KO	Autogas
DIS	Garditex Hilti
Hogekamp	HREZ
EK	Paranox BKU
XON	Pune.
FUL	FVI
Fristo	Frischehalle
FKPP	Funa
ZCA	ZCA
Zappel	Intl. Paper
MCD	Dempewolf
Digiland	Dingeling
Demi	Davada Min.
JPM	J.A.Isenbart
MO	KEM
PG	Käohers
S	Sears TJA
JNJ	EBR
UK	Florinchen
Flösch	Fröndhoff
VTH
Marzipanfabrik Sto